top-of-doc=_manual.htm
sync-icons-bg=sync-icons-bg.htm
syncpc-filter-p=syncpc-filter-p.htm
syncpc-renamedelmoveshare-bg=syncpc-renamedelmoveshare-bg.htm
syncpcwb-acceptsharereq-p=syncpcwb-acceptsharereq-p.htm
syncpcwb-addversion-p=syncpcwb-addversion-p.htm
syncpcwb-checkfoldersize-p=syncpcwb-checkfoldersize-p.htm
syncpcwb-copymove-p=syncpcwb-copymove-p.htm
syncpcwb-createfolder-p=syncpcwb-createfolder-p.htm
syncpcwb-delete-p=syncpcwb-delete-p.htm
syncpcwb-delete-shared-folder-p=syncpcwb-delete-shared-folder-p.htm
syncpcwb-downloadfile-p=syncpcwb-downloadfile-p.htm
syncpcwb-emailnotsharedfolder-p=syncpcwb-emailnotsharedfolder-p.htm
syncpcwb-enableemailnot-p=syncpcwb-enableemailnot-p.htm
syncpcwb-fileman-so=syncpcwb-fileman-so.htm
syncpcwb-logout-p=syncpcwb-logout-p.htm
syncpcwb-publish-p=syncpcwb-publish-p.htm
syncpcwb-readonlyshare-p=syncpcwb-readonlyshare-p.htm
syncpcwb-rename-p=syncpcwb-rename-p.htm
syncpcwb-reserve-p=syncpcwb-reserve-p.htm
syncpcwb-search-p=syncpcwb-search-p.htm
syncpcwb-settings-so=syncpcwb-settings-so.htm
syncpcwb-sharenewfolder-p=syncpcwb-sharenewfolder-p.htm
syncpcwb-sharing-so=syncpcwb-sharing-so.htm
syncpcwb-sortfolder-p=syncpcwb-sortfolder-p.htm
syncpcwb-switchthumbnail-p=syncpcwb-switchthumbnail-p.htm
syncpcwb-unsharefolder-p=syncpcwb-unsharefolder-p.htm
syncpcwb-updatecollab-p=syncpcwb-updatecollab-p.htm
syncpcwb-updatephoto-p=syncpcwb-updatephoto-p.htm
syncpcwb-uploadfile-p=syncpcwb-uploadfile-p.htm
syncpcwb-viewhistory-p=syncpcwb-viewhistory-p.htm
syncpcwb-viewversion-p=syncpcwb-viewversion-p.htm
